// 01Antonica
arena=The Arena
befallen=Befallen
beholder=Gorge of King Xorbb
blackburrow=Blackburrow
cazicthule=Lost Temple of Cazic-Thule
commons=West Commonlands
eastkarana=Eastern Plains of Karana
ecommons=East Commonlands
everfrost=Everfrost
feerrott=The Feerrott
freporte=East Freeport
freportn=North Freeport
freportw=West Freeport
grobb=Grobb
gukbottom=Ruins of Old Guk
guktop=Guk
halas=Halas
highkeep=High Keep
highpass=Highpass Hold
innothule=Innothule Swamp
kithicor=Kithicor Woods
lakerathe=Lake Rathetear
lavastorm=Lavastorm Mountains
misty=Misty Thicket
najena=Najena
nektulos=The Nektulos Forest
neriaka=Neriak Foreign Quarter
neriakb=Neriak Commons
neriakc=Neriak Third Gate
northkarana=Northern Plains of Karana
nro=Northern Desert of Ro
oasis=Oasis of Marr
oggok=Oggok
paw=Infected Paw
permafrost=Permafrost Caverns
qcat=Qeynos Aqueduct System
qey2hh1=Western Plains of Karana
qeynos=South Qeynos
qeynos2=North Qeynos
qeytoqrg=Qeynos Hills
qrg=Surefall Glade
rathemtn=Rathe Mountains
rivervale=Rivervale
runnyeye=Runnyeye Citadel
soldunga=Solusek's Eye
soldungb=Nagafen's Lair
soltemple=Temple of Solusek Ro
southkarana=Southern Plains of Karana
sro=Southern Desert of Ro

// 02Faydwer
akanon=Ak'Anon
butcher=Butcherblock Mountains
cauldron=Dagnor's Cauldron
crushbone=Crushbone
felwithea=Northern Felwithe
felwitheb=Southern Felwithe
gfaydark=Greater Faydark
kaladima=South Kaladim
kaladimb=North Kaladim
kedge=Kedge Keep
lfaydark=Lesser Faydark
mistmoore=Castle Mistmoore
oot=Ocean of Tears
steamfont=Steamfont Mountains
unrest=Estate of Unrest

// 03Odus
erudint=Erudin Palace
erudnext=Erudin
erudsxing=Erud's Crossing
hole=The Hole
kerraridge=Kerra Isle
paineel=Paineel
stonebrunt=Stonebrunt Mountains
toxxulia=Toxxulia Forest
warrens=Warrens

// 04The Planes
airplane=Plane of Air
fearplane=Plane of Fear
hateplane=Plane of Hate

// 05Kunark
burningwood=The Burning Wood
cabeast=Cabilis East
cabwest=Cabilis West
charasis=Howling Stones
chardok=Chardok
citymist=The City of Mist
dalnir=Dalnir
dreadlands=Dreadlands
droga=Temple of Droga
emeraldjungle=The Emerald Jungle
fieldofbone=Field of Bone
firiona=Firiona Vie
frontiermtns=Frontier Mountains
kaesora=Kaesora
karnor=Karnor's Castle
kurn=Kurn's Tower
lakeofillomen=Lake of Ill Omen
nurga=Mines of Nurga
overthere=The Overthere
sebilis=Old Sebilis
skyfire=Skyfire Mountains
swampofnohope=Swamp Of No Hope
timorous=Timorous Deep
trakanon=Trakanon's Teeth
veeshan=Veeshan's Peak
warslikswood=Warsliks Woods

// 06Velious
cobaltscar=Cobalt Scar
crystal=Crystal Caverns
eastwastes=Eastern Wastelands
frozenshadow=Tower of Frozen Shadow
greatdivide=Great Divide
growthplane=Plane of Growth
iceclad=Iceclad Ocean
kael=Kael Drakkel
mischiefplane=Plane of Mischief
necropolis=Dragon Necropolis
sirens=Sirens Grotto
skyshrine=Skyshrine
sleeper=Sleepers Tomb
templeveeshan=Temple of Veeshan
thurgadina=City of Thurgadin
thurgadinb=Icewell Keep
velketor=Velketor's Labyrinth
wakening=The Wakening Lands
westwastes=Western Wastelands